111111111111120000000141120000000101100001010101101110210101100005010001100005010001120000010001101111111101100000000001100001110041111111111111
120000000141
120000000141
100001010101
101110210101
100005010001
100000010001
120000010001
101111111101
100000000001
100001110041
111111111111